#########
# C   cX#
#  C #XX#
# C  #  #
#  ##S  #
#       #
#  ###  #
#########